oooooooooooo
o,,..,.,.,.o
o...,,..,,,o
o,.,.,,,..,o
o.,...,,..,o
o,,,.,,...,o
o..,.,,,.,,o
o.,,...,,,.o
o..,,,,..,.o
o,..,,..,,,o
o.,.,,.....o
o.,..,..,,.o
o.,..,.,.,,o
o.,.,....,,o
o,..,..,,,.o
o,,,.,,,.,.o
o.,...,..,.o
o,,,,.,.,,.o
o,,..,,,,,,o
o,,,,.,.,..o
o,,.,,.,..,o
o.,..,.,,,.o
o,..,,...,,o
o.,.,,..,..o
o..,....,..o
o,,,......,o
o,,.,,....,o
o,.,,,,.,,,o
o....,..,..o
o,....,,.,.o
o.,,..,..,.o
oooooooooooo
